duck=утка.
car=машина.
elevator=лифт.
frog=лягушка.
dog=собака.
cat=кошка.
pen=ручка.
desk=парта.
love=любовь.
toy=игрушка.
hammer=молот.
wait=ждать.
life=жизнь.
ambush=засада.
magic=магия.
world=мир.
forest=лес.
think=думать.
cup=чашка.
cast=слепок.
jasmine=жасмин.
cinder=зола.
music=музыка.
flint=огниво.
water=вода.
meaning=смысл.
search=искать.
time=время.
school=школа.
river=река.
